"filename", "language", "Dart", "comment", "blank", "total"
"/Users/xusun/Desktop/Flutter/offershow/lib/asset/modal.dart", "Dart", -3, 0, 0, -3
"/Users/xusun/Desktop/Flutter/offershow/lib/components/leftNavi.dart", "Dart", 1, 0, 0, 1
"/Users/xusun/Desktop/Flutter/offershow/lib/components/newNaviBar.dart", "Dart", 131, 0, 5, 136
"/Users/xusun/Desktop/Flutter/offershow/lib/components/titleBar.dart", "Dart", 11, 0, 3, 14
"/Users/xusun/Desktop/Flutter/offershow/lib/components/topic.dart", "Dart", 19, 0, 0, 19
"/Users/xusun/Desktop/Flutter/offershow/lib/components/totop.dart", "Dart", 44, 0, 0, 44
"/Users/xusun/Desktop/Flutter/offershow/lib/main_desktop.dart", "Dart", 4, 1, 2, 7
"/Users/xusun/Desktop/Flutter/offershow/lib/page/PicSquare/pic_square.dart", "Dart", 171, 0, 4, 175
"/Users/xusun/Desktop/Flutter/offershow/lib/page/about/about.dart", "Dart", 17, 2, 1, 20
"/Users/xusun/Desktop/Flutter/offershow/lib/page/account/account.dart", "Dart", 4, 0, 0, 4
"/Users/xusun/Desktop/Flutter/offershow/lib/page/collection_detail/collection_detail.dart", "Dart", 10, 0, 0, 10
"/Users/xusun/Desktop/Flutter/offershow/lib/page/collection_tab/collection_tab.dart", "Dart", 8, 0, 0, 8
"/Users/xusun/Desktop/Flutter/offershow/lib/page/column/column.dart", "Dart", 7, 0, 0, 7
"/Users/xusun/Desktop/Flutter/offershow/lib/page/essence/essence.dart", "Dart", 6, 0, 0, 6
"/Users/xusun/Desktop/Flutter/offershow/lib/page/home.dart", "Dart", 3, 0, 0, 3
"/Users/xusun/Desktop/Flutter/offershow/lib/page/home/homeNew.dart", "Dart", 6, 0, 0, 6
"/Users/xusun/Desktop/Flutter/offershow/lib/page/home/myhome.dart", "Dart", 2, 0, 0, 2
"/Users/xusun/Desktop/Flutter/offershow/lib/page/hot/homeHotNoScaffold.dart", "Dart", 11, 0, 0, 11
"/Users/xusun/Desktop/Flutter/offershow/lib/page/login/login.dart", "Dart", 18, 0, 0, 18
"/Users/xusun/Desktop/Flutter/offershow/lib/page/login/login_helper.dart", "Dart", 8, 0, 0, 8
"/Users/xusun/Desktop/Flutter/offershow/lib/page/me_func/me_func.dart", "Dart", 5, 0, 0, 5
"/Users/xusun/Desktop/Flutter/offershow/lib/page/msg_three/msg_three.dart", "Dart", 7, 0, 0, 7
"/Users/xusun/Desktop/Flutter/offershow/lib/page/new/draft.dart", "Dart", 60, 0, 7, 67
"/Users/xusun/Desktop/Flutter/offershow/lib/page/new/left_row_btn.dart", "Dart", 294, 9, 6, 309
"/Users/xusun/Desktop/Flutter/offershow/lib/page/new/new.dart", "Dart", -809, -2, -27, -838
"/Users/xusun/Desktop/Flutter/offershow/lib/page/new/right_row_btn.dart", "Dart", 191, 8, 4, 203
"/Users/xusun/Desktop/Flutter/offershow/lib/page/new/select_tag.dart", "Dart", 152, 0, 12, 164
"/Users/xusun/Desktop/Flutter/offershow/lib/page/new/success_display.dart", "Dart", 90, 0, 4, 94
"/Users/xusun/Desktop/Flutter/offershow/lib/page/new/vote_machine.dart", "Dart", 153, 0, 4, 157
"/Users/xusun/Desktop/Flutter/offershow/lib/page/new_reply/homeNewReply.dart", "Dart", 5, 0, 0, 5
"/Users/xusun/Desktop/Flutter/offershow/lib/page/person_detail/personDetail.dart", "Dart", 6, 0, 0, 6
"/Users/xusun/Desktop/Flutter/offershow/lib/page/personal/personal.dart", "Dart", 5, 0, 0, 5
"/Users/xusun/Desktop/Flutter/offershow/lib/page/photo_view/photo_view.dart", "Dart", 83, 0, 3, 86
"/Users/xusun/Desktop/Flutter/offershow/lib/page/question/question.dart", "Dart", 13, 0, 0, 13
"/Users/xusun/Desktop/Flutter/offershow/lib/page/search/search.dart", "Dart", 13, 0, 0, 13
"/Users/xusun/Desktop/Flutter/offershow/lib/page/setting/setting.dart", "Dart", 4, 0, 0, 4
"/Users/xusun/Desktop/Flutter/offershow/lib/page/square/square.dart", "Dart", 4, 0, 0, 4
"/Users/xusun/Desktop/Flutter/offershow/lib/page/square/squareHome.dart", "Dart", 8, 0, 0, 8
"/Users/xusun/Desktop/Flutter/offershow/lib/page/topic/At_someone.dart", "Dart", 2, 0, 0, 2
"/Users/xusun/Desktop/Flutter/offershow/lib/page/topic/Your_emoji.dart", "Dart", 8, 0, 2, 10
"/Users/xusun/Desktop/Flutter/offershow/lib/page/topic/alter_sent.dart", "Dart", 1, 0, 0, 1
"/Users/xusun/Desktop/Flutter/offershow/lib/page/topic/detail_cont.dart", "Dart", 90, 0, 0, 90
"/Users/xusun/Desktop/Flutter/offershow/lib/page/topic/topic_RichInput.dart", "Dart", 19, 5, 0, 24
"/Users/xusun/Desktop/Flutter/offershow/lib/page/topic/topic_detail.dart", "Dart", 14, 0, 0, 14
"/Users/xusun/Desktop/Flutter/offershow/lib/page/topic/topic_detailBottom.dart", "Dart", 6, 0, 0, 6
"/Users/xusun/Desktop/Flutter/offershow/lib/page/user_list/user_list.dart", "Dart", 9, 0, 0, 9
"/Users/xusun/Desktop/Flutter/offershow/lib/page/waterTask/task_list.dart", "Dart", 5, 0, 0, 5
"/Users/xusun/Desktop/Flutter/offershow/lib/page/waterTask/water_inout_detail.dart", "Dart", 6, 0, 0, 6
"/Users/xusun/Desktop/Flutter/offershow/lib/page/waterTask/water_task.dart", "Dart", 14, 0, 0, 14
"/Users/xusun/Desktop/Flutter/offershow/lib/page/water_total/water_total.dart", "Dart", 6, 0, 0, 6
"Total", "-", 942, 23, 30, 995